11 13 4 8 2 60
H H H H H H H H H H H H H
H 1 . S . . . . . S . 2 H
H . H . H . H . H . H . H
H S . S . S . S . S . S H
H . H . H . H . H . H . H
H . . . . A . R . . . . H
H . H . H . H . H . H . H
H S . S . S . S . S . S H
H . H . H . H . H . H . H
H . . S . . . . . S . . H
H H H H H H H H H H H H H
