17 25 4 14 5 60
H H H H H H H H H H H H H H H H H H H H H H H H H
H 1 . . . . . . . . . . . . . . . . . . . . . 2 H
H . H . H . H . H . H . H . H . H . H . H . H . H
H S . S . S . . . S . S . . . S . S . . . S . S H
H . H R H . H . H A H . H . H . H R H . H . H . H
H . . . . S . . . . . . . . . . . . . S . . . . H
H . H . H . H N H . H . H T H . H . H N H . H . H
H S . . . . . . . S . . . . . . . S . . . . . S H
H . H A H . H . H . H . H . H . H . H . H . H R H
H S . . . . . . . S . . . . . . . S . . . . . S H
H . H . H N H . H . H A H . H . H . H . H . H . H
H . . . . S . . . . . . . . . . . . . S . . . . H
H . H . H . H . H R H . H N H . H . H A H . H . H
H S . S . S . . . S . S . . . S . S . . . S . S H
H . H . H . H . H . H . H . H . H . H . H . H . H
H 3 . . . . . . . . . . . . . . . . . . . . . 4 H
H H H H H H H H H H H H H H H H H H H H H H H H H
