17 25 4 14 5 60
H H H H H H H H H H H H H H H H H H H H H H H H H
H 1 . . . . . . . S . . . S . . . . . . . . . 2 H
H . H H H H H H H . H H H . H H H H H H H . H . H
H S . S H S . . . S . S H . . S . S . . . S H S H
H . H R H . H S H A H . H . H . H R H . H H H . H
H . H . H S . . . . . . . . . S . . . S . . . . H
H . H . H . H N H H H S H T H . H . H N H . H . H
H S . . S . H . . S . . . . S . . S . . . . . S H
H . H A H . H . H . H H H . H S H . H H H . H R H
H S . . H . . . . S . . H . S . . S . . . . . S H
H . H . H N H . H . H A H H H . H . H H H H H . H
H . . . H S . . S . . . . S . . . . H S . . . . H
H H H . H . H H H R H . H N H H H . H A H H H . H
H S . S H S . . . S . S . . . S . S . . . S H S H
H . H H H . H H H H H H H H H H H H H . H H H . H
H 3 . . . . . . . . S . S . S . . . . . . . . 4 H
H H H H H H H H H H H H H H H H H H H H H H H H H
